dam	area
airport	area
beach	area
city	area
conflict	area
crop	area
disaster	area
drought	area
fire	area
flood	area
garage	area
harbor	area
hazard	area
home	area
jungle	area
lake	area
landing	area
metro	area
mountain	area
redevelopment	area
reservoir	area
resort	area
valley	area
water	area
wilderness	area

accident	site
airport	site
blast	site
bomb	site
company	site
crash	site
dam	site
job	site
plant	site
radar	site
school	site
stadium	site
test	site
waste	site
weapon	site

flood	plain

battle	zone
business	zone
conflict	zone
disaster	zone
earthquake	zone
euro	zone
export	zone
no-fly	zone
rouble	zone
ruble	zone
strike	zone
technology	zone
time	zone
