funding	plan
income	plan
independence	plan
peace	plan
autonomy	plan
energy	plan
finance	plan
energy	strategy

pension	rights
reform	drive
sex	drive
pension	age
school	age

truth	commission

performance	pay
membership	fee

photo	opportunity

health	club

fitness	program

lunch	menu

bowl	bid

sex	slave

coffee	break

bankruptcy	candidate

degree	course

cash	copper
cash	crop

touchdown	drive

course	enrollment

job	interview

suntan	lotion

job	opportunity
profit	opportunity

permit	process

food	queue

joy	ride
thrill	ride

due process	right
employment	right
job	right
land	rights
ownership	right
pension	right
privacy	rights
television	right
trademark	rights
video	rights

college	saver

fingerprint	service

raffle	ticket


