Michael	Smith
Elizabeth	Johnson
Thomas	Brown
Isaac	Brantz
Peter	Roberts
Joe	Sanders
Marsha	Baker
Carmen	Solomon
Aaron	Peters
Debra	Levin
Dirk	Schoenberg
Jeremy	Jacobson
Barack	Obama
Ronald	Reagan
John	Kennedy
Joseph	Truman
Tyler	Johnson
Ryan	Rutherford
Tim	Finn
Larry	Heinz
Sandra	Hewlett
Sarah	Boyle
Anthony	Zuckerman
James	Menendez
Nick	Dudley
Paul	Zhang
Owen	Morigawa
Charles	O'Brien
Fozzy	Katz
Kirsten	Schneider
Ashley	Schmidt
James	O'Donnell
Christie	Patterson
Christopher	Fujimori
Thomas	Messinger
Ken	Lebowski
Kirk	Tomaski
Wolf	Sondheim
Nitya	Harrington
Ezra	Smith
George	Thomas
Thorsten	McDonald
Anthony	McJames
Howard	McVeigh
Steven	Spielberg
Brian	Silverstein
Alan	Matsui
Alex	Deukmejian
Benjamin	Davis
Raymond	Sprout
Keith	Williams
Carlos	Thompson
Alice	Franklin
Billy	Showalter
Rudolph	Kagen
Lisa	Watkins
Laura	Gershwin
Max	Martinez
Doug	Woodward
Oliver	Perkins
Victor	Adler
Gregory	Eisenhower
Catherine	Ashcroft
Frederick	Torricelli
Eddie	Thatcher
Julia	Rosenthal
Pierre	Rockefeller
Vladimir	Aristide
Dorothy	Einstein
Malcolm	Kaufman
Brad	Nichols
Leo	Gephardt
Ian	Shapiro
Theodore	Manning
Ted	Holmes
Sally	Buchanan
Rebecca	Seyer
Edmond	Snyder
William	Fernandez
Stephan	Gilbert
Stephanie	Sanchez
Jaime	Winston
Lance	Bond
Katherine	Richardson
Pamela	Samson
Lucy	Tyson
Josh	Gorbachev
Reggie	Nikov
Pam	Barkowitz
Joseph	Hussein
Vlad	Williams
Forrestor	Kennedy
Byron	James
Jorge	Peter
Eleanor	Mark
Randall	Jones
Kathy	Jean
Maureen	Fitzwater
Amanda	Fitzpatrick
Bonnie	Blumenthal
