tax	matter
money	matter
policy	matter
budget	matter
immigration	matter
defense	matter
security	matter
health	matter
intelligence	matter

business	affair
league	affair

tax	question
geography	question
improvement	question
safety	question
trivia	question
probate	question
border	question
dividend	question
science	question
policy	question
budget	question
security	question
abortion	question

health	issue
budget	issue
mortgage	issue
border	issue
status	issue
campaign	issue
tax	issue
prisoner	issue
debenture	issue
crime	issue
airline	issue
scrip	issue
property	issue
liability	issue
election	issue
defense	issue
telecommunication	issue
arms	issue
energy	issue
settlement	issue
money	issue
ethic	issue
consumer	issue
computer	issue
transportation	issue
immigration	issue
privacy	issue
government	issue
gold	issue
health care	issue
gold mining	issue
water	issue
flag	issue
family	issue
character	issue
utility	issue
growth	issue
statehood	issue
debt	issue
trade	issue
investing	issue
hostage	issue
security	issue
disarmament	issue
inspection	issue
development	issue
finance	issue
banking	issue
minority	issue
policy	issue
world	issue
labor	issue
safety	issue
environment	issue
human rights	issue
land	issue
business	issue
race	issue
copyright	issue
right	issue
contract	issue
technology	issue
employment	issue
competition	issue
pay	issue
peace	issue
insurance	issue
impeachment	issue
investment	issue
currency	issue
missile	issue
compensation	issue
accounting	issue
privatisation	issue
biotechnology	issue
oil	issue
refugee	issue
gender	issue
aid	issue
reform	issue
management	issue
drug	issue

gift	idea

jail	sentence
death	sentence

security	concept

safety	reason
family	reason
health	reason
tax	reason
security	reason
